28
32
1 1 1 1 1 1 1 1 1 1 1 1 1 0 0 1 1 1 1 1 1 1 1 1 1 1 1 1
1 1 1 1 1 1 1 1 1 1 1 1 1 1 1 1 1 1 1 1 1 1 1 1 1 1 1 1
1 6 6 6 6 6 6 6 6 6 6 6 6 1 1 6 6 6 6 6 6 6 6 6 6 6 6 1
1 6 1 1 1 1 6 1 1 1 1 1 6 1 1 6 1 1 1 1 1 6 1 1 1 1 6 1
1 8 1 1 1 1 6 1 1 1 1 1 6 1 1 6 1 1 1 1 1 6 1 1 1 1 8 1
1 6 1 1 1 1 6 1 1 1 1 1 6 1 1 6 1 1 1 1 1 6 1 1 1 1 6 1
1 6 6 6 6 6 6 6 6 6 6 6 6 6 6 6 6 6 6 6 6 6 6 6 6 6 6 1
1 6 1 1 1 1 6 1 1 6 1 1 1 1 1 1 1 1 6 1 1 6 1 1 1 1 6 1
1 6 1 1 1 1 6 1 1 6 1 1 1 1 1 1 1 1 6 1 1 6 1 1 1 1 6 1
1 6 6 6 6 6 6 1 1 6 6 6 6 1 1 6 6 6 6 1 1 6 6 6 6 6 6 1
1 1 1 1 1 1 6 1 1 1 1 1 0 1 1 0 1 1 1 1 1 6 1 1 1 1 1 1
1 1 1 1 1 1 6 1 1 1 1 1 0 1 1 0 1 1 1 1 1 6 1 1 1 1 1 1
1 1 1 1 1 1 6 1 1 0 0 0 0 0 0 0 0 0 0 1 1 6 1 1 1 1 1 1
1 1 1 1 1 1 6 1 1 0 1 1 1 2 2 1 1 1 0 1 1 6 1 1 1 1 1 1
1 1 1 1 1 1 6 1 1 0 1 1 0 0 0 0 1 1 0 1 1 6 1 1 1 1 1 1
3 0 0 0 0 0 6 0 0 0 1 1 0 0 0 0 1 1 0 0 0 6 0 0 0 0 0 3
1 1 1 1 1 1 6 1 1 0 1 1 0 0 0 0 1 1 0 1 1 6 1 1 1 1 1 1
1 1 1 1 1 1 6 1 1 0 1 1 1 1 1 1 1 1 0 1 1 6 1 1 1 1 1 1
1 1 1 1 1 1 6 1 1 0 0 0 0 0 0 0 0 0 0 1 1 6 1 1 1 1 1 1
1 1 1 1 1 1 6 1 1 0 1 1 1 1 1 1 1 1 0 1 1 6 1 1 1 1 1 1
1 1 1 1 1 1 6 1 1 0 1 1 1 1 1 1 1 1 0 1 1 6 1 1 1 1 1 1
1 6 6 6 6 6 6 6 6 6 6 6 6 1 1 6 6 6 6 6 6 6 6 6 6 6 6 1
1 6 1 1 1 1 6 1 1 1 1 1 6 1 1 6 1 1 1 1 1 6 1 1 1 1 6 1
1 6 1 1 1 1 6 1 1 1 1 1 6 1 1 6 1 1 1 1 1 6 1 1 1 1 6 1
1 8 6 6 1 1 6 6 6 6 6 6 6 0 6 6 6 6 6 6 6 6 1 1 6 6 8 1
1 1 1 6 1 1 6 1 1 6 1 1 1 1 1 1 1 1 6 1 1 6 1 1 6 1 1 1
1 1 1 6 1 1 6 1 1 6 1 1 1 1 1 1 1 1 6 1 1 6 1 1 6 1 1 1
1 6 6 6 6 6 6 1 1 6 6 6 6 1 1 6 6 6 6 1 1 6 6 6 6 6 6 1
1 6 1 1 1 1 1 1 1 1 1 1 6 1 1 6 1 1 1 1 1 1 1 1 1 1 6 1
1 6 1 1 1 1 1 1 1 1 1 1 6 1 1 6 1 1 1 1 1 1 1 1 1 1 6 1
1 6 6 6 6 6 6 6 6 6 6 6 6 6 6 6 6 6 6 6 6 6 6 6 6 6 6 1
1 1 1 1 1 1 1 1 1 1 1 1 1 1 1 1 1 1 1 1 1 1 1 1 1 1 1 1 