28
32
1 1 1 1 1 1 1 1 1 1 1 1 1 0 0 1 1 1 1 1 1 1 1 1 1 1 1 1
1 1 1 1 1 1 1 1 1 1 1 1 1 1 1 1 1 1 1 1 1 1 1 1 1 1 1 1
1 5 5 5 5 5 5 5 5 5 5 5 5 1 1 5 5 5 5 5 5 5 5 5 5 5 5 1
1 5 1 1 1 1 5 1 1 1 1 1 5 1 1 5 1 1 1 1 1 5 1 1 1 1 5 1
1 6 1 1 1 1 5 1 1 1 1 1 5 1 1 5 1 1 1 1 1 5 1 1 1 1 6 1
1 5 1 1 1 1 5 1 1 1 1 1 5 1 1 5 1 1 1 1 1 5 1 1 1 1 5 1
1 5 5 5 5 5 5 5 5 5 5 5 5 5 5 5 5 5 5 5 5 5 5 5 5 5 5 1
1 5 1 1 1 1 5 1 1 5 1 1 1 1 1 1 1 1 5 1 1 5 1 1 1 1 5 1
1 5 1 1 1 1 5 1 1 5 1 1 1 1 1 1 1 1 5 1 1 5 1 1 1 1 5 1
1 5 5 5 5 5 5 1 1 5 5 5 5 1 1 5 5 5 5 1 1 5 5 5 5 5 5 1
1 1 1 1 1 1 5 1 1 1 1 1 0 1 1 0 1 1 1 1 1 5 1 1 1 1 1 1
1 1 1 1 1 1 5 1 1 1 1 1 0 1 1 0 1 1 1 1 1 5 1 1 1 1 1 1
1 1 1 1 1 1 5 1 1 0 0 0 0 0 0 0 0 0 0 1 1 5 1 1 1 1 1 1
1 1 1 1 1 1 5 1 1 0 1 1 1 2 2 1 1 1 0 1 1 5 1 1 1 1 1 1
1 1 1 1 1 1 5 1 1 0 1 1 0 0 0 0 1 1 0 1 1 5 1 1 1 1 1 1
3 0 0 0 0 0 5 0 0 0 1 1 0 0 0 0 1 1 0 0 0 5 0 0 0 0 0 3
1 1 1 1 1 1 5 1 1 0 1 1 0 0 0 0 1 1 0 1 1 5 1 1 1 1 1 1
1 1 1 1 1 1 5 1 1 0 1 1 1 1 1 1 1 1 0 1 1 5 1 1 1 1 1 1
1 1 1 1 1 1 5 1 1 0 0 0 0 0 0 0 0 0 0 1 1 5 1 1 1 1 1 1
1 1 1 1 1 1 5 1 1 0 1 1 1 1 1 1 1 1 0 1 1 5 1 1 1 1 1 1
1 1 1 1 1 1 5 1 1 0 1 1 1 1 1 1 1 1 0 1 1 5 1 1 1 1 1 1
1 5 5 5 5 5 5 5 5 5 5 5 5 1 1 5 5 5 5 5 5 5 5 5 5 5 5 1
1 5 1 1 1 1 5 1 1 1 1 1 5 1 1 5 1 1 1 1 1 5 1 1 1 1 5 1
1 5 1 1 1 1 5 1 1 1 1 1 5 1 1 5 1 1 1 1 1 5 1 1 1 1 5 1
1 6 5 5 1 1 5 5 5 5 5 5 5 0 5 5 5 5 5 5 5 5 1 1 5 5 6 1
1 1 1 5 1 1 5 1 1 5 1 1 1 1 1 1 1 1 5 1 1 5 1 1 5 1 1 1
1 1 1 5 1 1 5 1 1 5 1 1 1 1 1 1 1 1 5 1 1 5 1 1 5 1 1 1
1 5 5 5 5 5 5 1 1 5 5 5 5 1 1 5 5 5 5 1 1 5 5 5 5 5 5 1
1 5 1 1 1 1 1 1 1 1 1 1 5 1 1 5 1 1 1 1 1 1 1 1 1 1 5 1
1 5 1 1 1 1 1 1 1 1 1 1 5 1 1 5 1 1 1 1 1 1 1 1 1 1 5 1
1 5 5 5 5 5 5 5 5 5 5 5 5 5 5 5 5 5 5 5 5 5 5 5 5 5 5 1
1 1 1 1 1 1 1 1 1 1 1 1 1 1 1 1 1 1 1 1 1 1 1 1 1 1 1 1 